111111111111111111111111
1E000V0000VV010C00001C01
1000000000CV011V11001101
100V000000V0000000000001
100000000000000V00000001
100001111111000000000001
10V00110C01100000V000001
100001100011000000000001
1000011V0000000000001101
111101111111101110001001
111100000V000000000010E1
1P000000000000000000V001
111111111111111111111111