1111111111111111111111111
1P00000000000000000000001
1010010100100000101001001
1010010010101010001001001
1000E00V000C0000000000001
1111111111111111111111111